################
#              #
# ## # ## # ## #
# ## ###### ## #
#              #
#    ######    #
#    ######    #
#              #
#              #
#              #
#              #
#              #
# S            #
#              #
################